3 
Image/stage1Map.bmp 
Image/_stage2Map.bmp 
Image/stage3Map.bmp 
Image/stage1Map.bmp 

1 4 3 100 100 100 150 
1 2 3 100 100 70 30 
1 2 3 100 100 70 30 
1 4 3 100 100 100 150 

2 5 2 200 200 70 30 
3 5 1 200 200 70 30 
2 5 3 200 200 70 30 
2 5 2 200 200 70 30 

5 3 2 50 300 80 100 
4 2 1 50 200 70 30 
3 3 1 50 200 70 30 
5 3 2 50 300 80 100 

10 5 3 100 300 70 50 
5 2 1 100 300 70 30 
4 5 1 100 300 70 30 
10 5 3 100 300 70 50 

15 1 1 100 200 70 30 
15 1 3 100 200 70 30 
15 1 1 100 200 70 30
15 1 1 100 200 70 30 

20 4 3 100 100 100 150 
20 2 3 100 100 70 30 
20 2 3 100 100 70 30 
20 4 3 100 100 100 150 

23 5 2 200 200 70 30 
23 5 1 200 200 70 30 
24 5 3 200 200 70 30 
24 5 2 200 200 70 30 

28 3 2 50 300 80 100 
28 2 1 50 200 70 30 
28 3 1 50 200 70 30 
28 3 2 50 300 80 100 

32 5 3 100 300 70 50 
32 2 1 100 300 70 30 
32 5 1 100 300 70 30 
32 5 3 100 300 70 50 

35 1 1 100 200 70 30 
35 1 3 100 200 70 30 
35 1 1 100 200 70 30
35 1 1 100 200 70 30 




// 맨위는 maxstage의 값에서 -1 해준 값입력 
// 그다음 부터는 순차적으로   
enemyWaveSet1[maxstage][7];
enemyWaveSet2[maxstage][7];
enemyWaveSet3[maxstage][7] ;
enemyWaveSet4[maxstage][7];
enemyWaveSet5[maxstage][7];  이며 7 개는 각각 출력시점(초)/ 출력될 몬스터 갯수/ 몬스터 타입/첫 몬스터의 좌표 x / y/ 몬스터 간 간격 x / y 
